9 16 6
################
#S..a..A..b..B.#
#...#..##..#...#
#..T..c..C..T..#
#..##..##..##..#
#..d..D..e..E..#
#...#..##..##..#
#..T..........T#
################
