8 14 5
##############
#S....a....A.#
#...#..##..$.#
#..T..b..B..##
#..##..##..###
#..c..C...T..#
#...........E#
##############
